0 3 1 3 1 6 0 6 0 6 1 5 1 5 0
0 0 2 1 2 1 0 0 0 1 2 1 2 0 0
0 3 1 3 1 6 7 6 7 6 1 5 1 5 0
2 1 2 1 6 7 7 1 7 7 6 1 2 1 2
1 6 1 6 7 7 6 0 6 7 7 6 1 6 1
2 0 7 0 0 6 1 1 1 6 0 0 7 0 2
2 6 1 6 0 2 0 0 0 2 0 6 1 6 2
2 0 7 0 0 6 1 1 1 6 0 0 7 0 2
1 6 1 6 7 7 6 2 6 7 7 6 1 6 1
2 1 2 1 6 7 7 1 7 7 6 1 2 1 2
0 5 1 5 1 6 7 6 7 6 1 4 1 4 0
0 0 2 1 2 1 0 0 0 1 2 1 2 0 0
0 5 1 5 1 6 0 6 0 6 1 4 1 4 0